NO textures/wood0.xpm
SO textures/wood1.xpm
WE textures/wood2.xpm
EA textures/wood3.xpm

F 18,53,25
C 153,204,255

1100110000000000000000000000000001
1100010000000000000000000111111111
1011000000000000100000000111 
10000000000000000000000001111
1000000N00000000100000001111
110000000000000110000001111
10000000000000011000000001111
11111111000000001000000001111
1111111111111111111111111111
