NO textures/wood0.xpm
SO textures/wood1.xpm
WE textures/wood2.xpm
EA textures/wood3.xpm

F 20,20,20
C 200,200,200
            1111111
            1001111
           10000111
          100000001
          100000001
111111111111000000111111   11111
10000000000000000000000111110011
1000000000000000000000000111001111
1000000000000000000000000000000111
1000000000000000000000011111111111
1000000000000000000000011
10000000000000000000000001
1000001101100000000000001
100000100010000000000001
100000100010000100010001111111
100000100010000100010001111111
100000100010000100010001111111
10000010001N0000000000000000111
10000011001110011111111011111
1000000000000100000000011
1000000000000100000000011
1000000000000100000000011
1000000000000100000000011
1000000000000100000000011
1000000000000100000000011
100000000000010000000001
111111111000010000000001
10010000100000000000000111
10000010000001000000000111
10010000100001000000000111
10011111100001000000000111
10000000000001000000000111
100000000000010000000001
111111111111111111111111