NO textures/wood0.xpm
SO textures/wood1.xpm
WE textures/wood2.xpm
EA textures/wood3.xpm

F 20,20,20
C 200,200,200
            1111111
            1001111
           10000111
          100000001
          100000001
111111111111000000111111   11111
10000000000000000000000111110011
1000000000000000000000000111001111
1000000000000000000000000000000111
10000000000000000000000000011111111111
10000000000000000000000000011
100000000000000000000000000001
1000001101100S000000000000001
1000001000100000000000000001
1000001000100001000100000001111111
1000001000100001000100000001111111
10000010001000010001000001111111
1000001000100000000000000000111
10000011001110011111111011111
1000000000000100000000000011
1000000000000100000000000011
1000000000000100000000000011
1000000000000100000000000011
1000000000000100000000000011
1000000000000100000000000011
100000000000010000000000001
1111111110000100000000000001
100100001000000000000000000111
100000100000010000000000000111
100100001000010000000000000111
100111111000010000000000000111
1000000000000100000000000000011111
1000000000000100000000000000011
1111111111111111111111111111111