NO             ./maps/1.png
SO             ./maps/4.png
WE             ./maps/2.png
EA             ./maps/3.png

F               111,5,25
C               119,181,254

        1111111111111111111111111
        1000000000010000000000001
        1011000000010000000000001
        1001000000000000000000001
111111111011000001110000000000001
100000000011000001110011111111111
11110111111111011100000010001
11110111111111011101010010001
110000001101S1011100000010001
10000000000000001100000010001
10000000000000000001010010001
1100000111010101110101111000111
11110111 1110101 101111010001
11111111 1111111 111111111111
