F 76,76,76
C 99,00,99

NO textures/wood0.xpm
SO textures/wood1.xpm
WE textures/wood2.xpm
EA textures/wood3.xpm

1111111111111111111
1001001001001000001
1D1100000D000001001
10S10010011111D1111
1001111000001001001
100000D000000001001
10011111D1111001001
1111000000000001011
1000000001000000001
1111111111111111111

