NO textures/wood0.xpm
SO textures/wood1.xpm
WE textures/wood2.xpm
EA textures/wood3.xpm

F 20,20,20
C 200,200,200

11111
101
101
101
101
101
101
101
101
101
101
1S1
111
